XXXXXXXXXXXXXXXXX
XXXXXXXXXXXXXXXXX
XXXXXXXXXXXXXXXXX
XXXXXXXXXXXXXXXXX
XXXXXXXXXXXXXXXXX
XXXXXXXXXXXXXXXXX
GTGBXGXGXBGTBBGXG
VVVVVVVVVVVVVVVVV
VVVVVVVVVVVVVVVVV